Architecture: RDNA4
Instruction: V_WMMA_F32_16X16X16_F16
+-----------+--------+--------+--------+--------+--------+--------+--------+--------+--------+--------+--------+--------+--------+--------+--------+--------+
|   D[M][N] | 0      | 1      | 2      | 3      | 4      | 5      | 6      | 7      | 8      | 9      | 10     | 11     | 12     | 13     | 14     | 15     |
+===========+========+========+========+========+========+========+========+========+========+========+========+========+========+========+========+========+
|         0 | v0{0}  | v0{1}  | v0{2}  | v0{3}  | v0{4}  | v0{5}  | v0{6}  | v0{7}  | v0{8}  | v0{9}  | v0{10} | v0{11} | v0{12} | v0{13} | v0{14} | v0{15} |
+-----------+--------+--------+--------+--------+--------+--------+--------+--------+--------+--------+--------+--------+--------+--------+--------+--------+
|         1 | v1{0}  | v1{1}  | v1{2}  | v1{3}  | v1{4}  | v1{5}  | v1{6}  | v1{7}  | v1{8}  | v1{9}  | v1{10} | v1{11} | v1{12} | v1{13} | v1{14} | v1{15} |
+-----------+--------+--------+--------+--------+--------+--------+--------+--------+--------+--------+--------+--------+--------+--------+--------+--------+
|         2 | v2{0}  | v2{1}  | v2{2}  | v2{3}  | v2{4}  | v2{5}  | v2{6}  | v2{7}  | v2{8}  | v2{9}  | v2{10} | v2{11} | v2{12} | v2{13} | v2{14} | v2{15} |
+-----------+--------+--------+--------+--------+--------+--------+--------+--------+--------+--------+--------+--------+--------+--------+--------+--------+
|         3 | v3{0}  | v3{1}  | v3{2}  | v3{3}  | v3{4}  | v3{5}  | v3{6}  | v3{7}  | v3{8}  | v3{9}  | v3{10} | v3{11} | v3{12} | v3{13} | v3{14} | v3{15} |
+-----------+--------+--------+--------+--------+--------+--------+--------+--------+--------+--------+--------+--------+--------+--------+--------+--------+
|         4 | v4{0}  | v4{1}  | v4{2}  | v4{3}  | v4{4}  | v4{5}  | v4{6}  | v4{7}  | v4{8}  | v4{9}  | v4{10} | v4{11} | v4{12} | v4{13} | v4{14} | v4{15} |
+-----------+--------+--------+--------+--------+--------+--------+--------+--------+--------+--------+--------+--------+--------+--------+--------+--------+
|         5 | v5{0}  | v5{1}  | v5{2}  | v5{3}  | v5{4}  | v5{5}  | v5{6}  | v5{7}  | v5{8}  | v5{9}  | v5{10} | v5{11} | v5{12} | v5{13} | v5{14} | v5{15} |
+-----------+--------+--------+--------+--------+--------+--------+--------+--------+--------+--------+--------+--------+--------+--------+--------+--------+
|         6 | v6{0}  | v6{1}  | v6{2}  | v6{3}  | v6{4}  | v6{5}  | v6{6}  | v6{7}  | v6{8}  | v6{9}  | v6{10} | v6{11} | v6{12} | v6{13} | v6{14} | v6{15} |
+-----------+--------+--------+--------+--------+--------+--------+--------+--------+--------+--------+--------+--------+--------+--------+--------+--------+
|         7 | v7{0}  | v7{1}  | v7{2}  | v7{3}  | v7{4}  | v7{5}  | v7{6}  | v7{7}  | v7{8}  | v7{9}  | v7{10} | v7{11} | v7{12} | v7{13} | v7{14} | v7{15} |
+-----------+--------+--------+--------+--------+--------+--------+--------+--------+--------+--------+--------+--------+--------+--------+--------+--------+
|         8 | v0{16} | v0{17} | v0{18} | v0{19} | v0{20} | v0{21} | v0{22} | v0{23} | v0{24} | v0{25} | v0{26} | v0{27} | v0{28} | v0{29} | v0{30} | v0{31} |
+-----------+--------+--------+--------+--------+--------+--------+--------+--------+--------+--------+--------+--------+--------+--------+--------+--------+
|         9 | v1{16} | v1{17} | v1{18} | v1{19} | v1{20} | v1{21} | v1{22} | v1{23} | v1{24} | v1{25} | v1{26} | v1{27} | v1{28} | v1{29} | v1{30} | v1{31} |
+-----------+--------+--------+--------+--------+--------+--------+--------+--------+--------+--------+--------+--------+--------+--------+--------+--------+
|        10 | v2{16} | v2{17} | v2{18} | v2{19} | v2{20} | v2{21} | v2{22} | v2{23} | v2{24} | v2{25} | v2{26} | v2{27} | v2{28} | v2{29} | v2{30} | v2{31} |
+-----------+--------+--------+--------+--------+--------+--------+--------+--------+--------+--------+--------+--------+--------+--------+--------+--------+
|        11 | v3{16} | v3{17} | v3{18} | v3{19} | v3{20} | v3{21} | v3{22} | v3{23} | v3{24} | v3{25} | v3{26} | v3{27} | v3{28} | v3{29} | v3{30} | v3{31} |
+-----------+--------+--------+--------+--------+--------+--------+--------+--------+--------+--------+--------+--------+--------+--------+--------+--------+
|        12 | v4{16} | v4{17} | v4{18} | v4{19} | v4{20} | v4{21} | v4{22} | v4{23} | v4{24} | v4{25} | v4{26} | v4{27} | v4{28} | v4{29} | v4{30} | v4{31} |
+-----------+--------+--------+--------+--------+--------+--------+--------+--------+--------+--------+--------+--------+--------+--------+--------+--------+
|        13 | v5{16} | v5{17} | v5{18} | v5{19} | v5{20} | v5{21} | v5{22} | v5{23} | v5{24} | v5{25} | v5{26} | v5{27} | v5{28} | v5{29} | v5{30} | v5{31} |
+-----------+--------+--------+--------+--------+--------+--------+--------+--------+--------+--------+--------+--------+--------+--------+--------+--------+
|        14 | v6{16} | v6{17} | v6{18} | v6{19} | v6{20} | v6{21} | v6{22} | v6{23} | v6{24} | v6{25} | v6{26} | v6{27} | v6{28} | v6{29} | v6{30} | v6{31} |
+-----------+--------+--------+--------+--------+--------+--------+--------+--------+--------+--------+--------+--------+--------+--------+--------+--------+
|        15 | v7{16} | v7{17} | v7{18} | v7{19} | v7{20} | v7{21} | v7{22} | v7{23} | v7{24} | v7{25} | v7{26} | v7{27} | v7{28} | v7{29} | v7{30} | v7{31} |
+-----------+--------+--------+--------+--------+--------+--------+--------+--------+--------+--------+--------+--------+--------+--------+--------+--------+
